LOL - Laughing out loud
BRB - Be right back
BTW - By the way
OMG - Oh my God
FYI - For your information
GTG - Got to go
TTYL - Talk to you later
SMH - Shaking my head
TBH - To be honest
NVM - Never mind
IMHO - In my humble opinion
ICYMI - In case you missed it
TMI - Too much information
BFF - Best friends forever
ASAP - As soon as possible
AFK - Away from keyboard
IDK - I don't know
ROFL - Rolling on the floor laughing
IRL - In real life
YOLO - You only live once
FOMO - Fear of missing out
TL;DR - Too long; didn't read
B4 - Before
DIY - Do it yourself
JK - Just kidding
OMW - On my way
TIA - Thanks in advance
PPL - People
TTFN - Ta-ta for now
HBD - Happy birthday
LMAO - Laughing my ass off
FWIW - For what it's worth
ICYMI - In case you missed it
BAE - Before anyone else
IDC - I don't care
ILY - I love you
LMK - Let me know
NSFW - Not safe for work
RSVP - Répondez s'il vous plaît (Please respond)
WFH - Work from home